- - - - - - x - - -
x - - - x - - x - -
- - - - - - - - - -
x x x - - - x x x -
- - - - - - - - x -
- - - - - - - - - -
- - - - - - - - - -
x - - - x - - - - -
- - - - - - - - - -
- - - - - R - - x -
