- - x - x - x - x -
- - - - - - - - - -
- x x - - - - - x -
x - x - x x x - - -
- - x - - - x - x -
x - x - R - x - - -
- - x x x x x - x -
x - - - - - - - - -
- - x x - x - x - -
- - - - - - - - - -
